0
0
1,2,3,10

1
1
0,2,3,10,11

2
2
0,1,3,4,12,20

3
3
0,1,2,4,5,13,30

4
4
0,2,3,5,6,40,14

5
5
0,3,4,6,7,15,50

6
6
0,4,5,7,8,16,60

7
7
0,5,6,70,8,9,17

8
8
0,6,7,9,10,80,18

9
9
0,7,8,10,11,19,90

10
10
0,1,100,8,9,11,12,20

11
11
1,9,10,12,13,110,21

12
12
1,2,10,11,13,14,21,22,120

13
13
1,130,3,11,12,14,15,23,31

14
14
1,4,41,12,13,140,15,16,24

15
15
1,5,13,14,16,17,51,150,25

16
16
160,1,6,14,15,17,18,26,61

17
17
1,71,7,170,15,16,18,19,27

18
18
1,8,16,17,81,19,20,180,28

19
19
1,9,17,18,20,21,91,29,190

20
20
0,2,200,18,19,21,22,30

30
30
32,0,3,40,300,28,29,31

40
40
0,4,38,39,41,42,400,50

50
50
0,5,48,49,51,52,500,60

60
60
0,70,6,600,58,59,61,62

70
70
0,68,69,71,72,7,80,700

80
80
800,0,8,78,79,81,82,90

90
90
0,100,900,9,88,89,91,92

21
21
1,2,12,210,19,20,22,23,31

31
31
32,33,1,3,41,13,310,29,30

41
41
1,4,39,40,42,43,14,51,410

51
51
1,5,15,49,50,52,53,61,510

61
61
1,610,6,71,16,59,60,62,63

71
71
1,69,70,710,72,73,7,81,17

81
81
1,8,810,79,80,82,83,18,91

91
91
1,101,9,910,19,89,90,92,93

25
25
2,35,5,250,52,23,24,26,27

50
50
0,5,48,49,51,52,500,60

75
75
5,7,73,74,76,77,750,85,57

99
99
97,98,100,101,9,109,990

