?\ \mathrm{smallest}
3
609,4,5,907,1004,80,208,250,30

?\ \mathrm{smallest}
1
610,97,932,40,74,307,22,90,29

?\ \mathrm{smallest}
4
808,1001,9,79,217,26,91,700,61

?\ \mathrm{smallest}
15
503,709,710,70,40,74,310,22,506

?\ \mathrm{smallest}
1
740,100,70,901,9,10,302,402,725

?\ \mathrm{smallest}
4
515,6,680,72,398,402,660,86,90

?\ \mathrm{smallest}
3
33,100,101,680,9,10,30,510

?\ \mathrm{smallest}
1
480,2,6,105,10,12,1004,540,701

?\ \mathrm{smallest}
2
161,3,994,357,8,75,908,50,601

?\ \mathrm{smallest}
5
550,6,37,171,108,20,89,604,350

?\ \mathrm{smallest}
10
706,36,590,309,23,120,601,63,95

?\ \mathrm{smallest}
1
802,4,37,10,907,306,660,59,798

?\ \mathrm{smallest}
10
35,810,110,80,50,820,22,410,28

?\ \mathrm{smallest}
3
67,70,7,10,80,50,20,599

?\ \mathrm{smallest}
5
609,710,10,300,110,208,409,157,30

?\ \mathrm{smallest}
8
128,770,772,759,80,23,91,60

?\ \mathrm{smallest}
3
704,5,70,709,40,79,90,861,670

?\ \mathrm{smallest}
14
104,875,620,80,51,20,90,91,638

?\ \mathrm{smallest}
1
100,6,40,751,80,273,20,309,830

?\ \mathrm{smallest}
4
801,70,710,204,620,15,80,85,30

?\ \mathrm{smallest}
2
32,7,39,9,10,940,1006,751,605

?\ \mathrm{smallest}
4
100,956,50,600,90,60,30

?\ \mathrm{smallest}
7
97,90,70,905,9,240,403,502,186

?\ \mathrm{smallest}
3
6,40,8,298,502,790,90,60

?\ \mathrm{smallest}
5
704,710,9,42,845,60,90,92,63

?\ \mathrm{largest}
910
3,100,390,40,10,143,21,60,831

?\ \mathrm{largest}
920
96,6,103,60,49,50,409,90,28

?\ \mathrm{largest}
860
96,705,802,810,780,340,503,504,730

?\ \mathrm{largest}
840
37,7,520,10,304,305,20,60,31

?\ \mathrm{largest}
1005
3,100,70,810,46,80,603,60

?\ \mathrm{largest}
860
3,8,73,234,202,21,406,90,30

?\ \mathrm{largest}
920
769,708,5,870,8,10,270,438,510

?\ \mathrm{largest}
901
97,290,164,840,841,13,699,60

?\ \mathrm{largest}
826
3,100,4,139,60,561,90,605

?\ \mathrm{largest}
830
290,610,40,105,10,240,560,574

?\ \mathrm{largest}
990
905,42,429,60,110,80,562,790,220

?\ \mathrm{largest}
950
3,900,100,4,6,810,50,406,922

?\ \mathrm{largest}
1002
66,100,5,873,363,406,860,413,510

?\ \mathrm{largest}
401
100,70,40,8,14,304,50,91,28

?\ \mathrm{largest}
710
2,4,390,10,620,400,51,30

?\ \mathrm{largest}
905
6,8,591,50,115,340,630,90,30

?\ \mathrm{largest}
809
805,72,40,750,50,20,437,536,604

?\ \mathrm{largest}
820
1,4,710,70,7,6,40,108,50

?\ \mathrm{largest}
960
3,804,4,390,40,617,586,50,22

?\ \mathrm{largest}
962
5,10,60,879,690,84,662,380,190

?\ \mathrm{largest}
907
641,6,60,307,90,603,380,671

?\ \mathrm{largest}
1002
705,6,72,234,908,10,240,346,29

?\ \mathrm{largest}
776
5,8,682,10,670,80,210,20,510

?\ \mathrm{largest}
880
1,2,9,60,403,404,54,376,700

?\ \mathrm{largest}
1007
160,33,610,99,70,40,20

