ggg|....|gg
ggg|....|gg
ggg|....|gg
ggg|....|gg
ggg|....|gg
ggg|....|gg
ggg|....|gg
ggg|....|gg
ggg|....|gG
ggg|....|gg
ggg|....|gg
gfg|....|gg
ggg|....|gg
ggg|....|gg
gtg|....|gg
ggg|....|gg
ggg|====|gg
ggg|....|gg
ggg|....|gg
ggg|....|gg
ggg|....|gg
ggg|....|gg
ggg|....|gg
ggg|....|gg
ggg|....|gg
ggg|....|gg
ggg|....|gg
ggg|....|gg
ggg|....|gg
ggg|....|gg
ggg|....|gg
ggg|....|gg
ggg|....|gg
ggg|....|gg
ggg|....|gg
ggg|....|gg
ggg|....|gg
ggg|....|gg
ggg|....|gg
ggg|....|gg
ggg|....|gg
ggg|...0|gg
ggg|....|gg
ggg|....|gg
ggg|....|gg
gfg|....|gg
ggg|....|gg
ggg|....|gg
ggg|....|gg
ggg|....|gg
ggg|....|gg
ggg|....|gg
ggg|....|gg
ggg|....|gg
gGg|....|gg
ggg|....|gg
ggg|....|gg
ggg|....|gg
ggg|....|gg
ggg|..1.|gg
ggg|....|gg
ggg|....|gg
ggg|....|gg
ggg|0...|gg
ggg|....|gg
ggg|....|gg
ggg|...p|gg
ggg|....|gg
ggg|....|gg
ggg|....|gg
ggg|....|gg
ggg|....|gg
ggg|....|gg
ggg|....|gg
ggg|eeee|gg
ggg|....|gg
ggg|....|gg
ggg|....|gg
ggg|....|gg
ggg|....|gg
ggg|....|gg
ggg|....|gg
ggg|....|gg
ggg|....|gg
ggg|....|gg
RRR|....|RR
ggg|....|gg
ggg|....|gg
ggg|....|gg
ggg|wwww|gg
ggg|....|gg
gSg|wwww|gg
ggg|....|gg
ggg|wwww|gg
ggg|....|gg
ggg|....|gg
ggg|....|gg
ggg|....|gg
gfg|....|gg
ggg|....|gg
ggg|....|gg
ggg|....|gg
ggg|....|gg
ggg|....|gg
ggg|....|gg
ggg|....|gg
ggg|....|gg
ggg|....|gg
ggg|....|gg
gfg|....|gg
ggg|....|gg
ggg|....|gg
gsg|....|gg
ggg|....|gg
ggg|....|gg
ggg|....|gg
ggg|....|gg
ggg|.0..|gg
ggg|....|gg
ggg|....|gg
ggg|....|gg
ggg|....|gg
gGg|....|gg
gGg|....|gg
gGg|....|gg
gGg|....|gg
ggg|....|gg
ggg|....|gg
ggg|....|gg
ggS|....|Sg
ggg|....|gg
ggg|....|gg
ggg|....|gg
ggg|....|gg
ggg|....|gg
gtg|....|gg
ggg|....|gg
ggg|....|gg
gfg|....|gg
ggg|....|gg
ggg|....|gg
ggg|....|gg
ggS|....|Sg
ggg|....|gg
ggg|....|gg
ggg|....|gg
ggg|....|gg
ggg|....|gg
ggg|....|gg
ggg|....|gg
ggg|....|gg
ggg|....|gg
ggg|....|gg
ggg|....|gg
ggS|....|Sg
ggg|....|gg
ggg|....|gg
ggg|....|gg
ggg|....|gg
ggg|....|gg
ggg|....|gg
ggg|....|gg
ggg|....|gg
ggg|....|gg
ggg|....|gg
ggg|....|gg
gtg|....|gg
ggg|....|gg
gggg\../ggg
gggg|..|ggg
gggg|..|ggg
RRRR|..|RRR
gggg|..|ggg
gggg|..|ggg
gggg|..|ggg
gggg|==|ggg 20
gggg|..|ggg
gggg|..|ggg
gggg|..|gfg
gggg|..|ggg
gggg|..|ggg
gggg|..|ggg
gggg|..|gfg
gggg|0.|ggg
gggg|..|ggg
gggg|..|ggg
gggg|..|ggg
gggg|..|ggg
gggg|..|ggg
gGGg|..|ggg
gggg|..|ggg
gggg|..|ggg
gggg|..|ggg
gggg|..|ggg
ggtg|..|ggg
gggg|..|ggg
gggg|..|ggg
gggg|..|ggg
gggg|..|gtg
gggg|..|ggg
gggg|..|ggg
gggg|..|ggg
gggg|..|ggg
gggg|.1|ggg
gggg|..|ggg
gggg|..|ggg
gggg|..|ggg
gggg|.b|ggg
gggg|..|ggg
gggg|..|ggg
gggg|..|ggg
gggg|..|ggg
gggg|..|ggg
gggg|..|ggg
gGGg|..|ggg
gggg|..|ggg
gggg|..|ggg
gggg|..|ggg
gggg/..|gGG
ggg|r..|gGG
ggg|r..|ggg
ggg|r..|ggg
ggg|r..|ggG
ggg|r..|ggG
ggg|r..|gGg
ggg|r..|gGg
ggg|r..|ggg
ggg|r..|ggg
ggg|r..|ggg
ggg|r..|ggg
ggg|r..|ggg
ggg|r..|ggg
ggg|r..|ggg
ggg|r..|ggg
ggg|r..|ggg
ggg|...|gtg
ggg|...|ggg
gtg|...|ggg
ggg|...|ggg
ggg|...|ggg
gtg|...|ggg
ggg|...|ggg
ggg|...|ggg
ggg|...|ggg
gtg|...|ggg
ggg|...|ggg
ggg|...|ggg
ggg|...|ggg
ggg|...|ggg
ggg|...|ggg
ggg|...|ggg
ggg|.0.|ggg
ggg|...|ggg
ggg|...|ggg
ggg|...|ggg
ggg|...|ggg
gfg|...|ggg
ggg|...|ggg
ggg|...|ggg
ggg|b..|ggg
ggg|...|ggg
ggg|...|ggg
ggg|...|ggg
ggg|...|ggg
gGg|...|ggg
ggg|...|ggg
ggg|...|ggg
ggg|...|ggg
ggg|...|ggg
ggg|...|ggg
ggg|...|ggg
gGg|...|ggg
ggg|...|ggg
ggg|...|ggg
ggg|...|ggg
ggg|...|ggg
ggg|...|ggg
ggg|...|ggg
Ggg|...|ggg
ggg|...|ggg
ggg|1..|ggg
ggg|...|ggg
ggg|...|ggg
ggg|...|ggg
ggg|...|ggg
RRR|...|RRR
ggg|...|ggg
ggg|...|ggg
ggg|...|ggg
ggg|...|ggg
ggg|...|gGG
ggg|...|gGg
ggg|...|gGg
ggg|...|ggg
ggg|...|gGg
ggg|...|ggG
ggg|...|ggg
Ggg|...|ggg
Ggg|...|ggg
gGg|...|ggg
ggg|...|gff
ggg|...|gff
gGg|...|gff
ggg|.b.|gff
ggg|...|ggg
ggg|...|ggg
ggg|...|ggg
ggg|...|ggg
ggg|...|ggg
ggg|..0|ggg
ggg|...|ggg
Ggg|...|ggg
gGg|...|ggg
ggg|...|ggg
ggg|...|ggg
ggg|...|ggg
ggg|...|ggg
ggg|...|gtg
ggg|...|gtg
ggg|...|ggg
ggg|...|ggg
ggg|...|ggg
ggg|...|ggg
ggg|.3.|ggg
ggg|...|ggg
gtg|...|ggg
gtg|...|ggg
gtg|...|gtg
gtg|...|gtg
ggg|...|ggg
ggg|...|ggg
ggg|.o.|ggg
ggg|...|ggg
ggg|...|ggg
ggg|...|ggg
ggg|...|ggg
ggg|...|ggg
ggg|...|ggg
ggg|...|ggg
ggg|...|ggg
ggg|...|ggg
ggg|...|ggg
ggg|...|ggg
ggg|...|ggg
ggg|...|ggg
ggg|...|ggg
ggg|...|ggg
ggg|...|ggg
ggg|...|ggg
ggg|===|ggg 30
ggg|...|ggg
ggg|...|ggg
ggg|...|ggg
ggg|...|ggg
ggg|...|ggg
ggg|...|ggg
ggg|...|ggg
ggg|...|ggg
ggg|...|ggg
ggg|...|ggg
ggg|...|ggg
ggg|...|ggg
ggg|...|ggg
ggg|...|ggg
ggg|...|ggg
ggg|...|ggg
ggg|...|ggg
